/* ************************************************************************** */
/*                                                                            */
/*                                                        :::      ::::::::   */
/*   map.cub                                            :+:      :+:    :+:   */
/*                                                    +:+ +:+         +:+     */
/*   By: nmichael <nmichael@student.42.fr>          +#+  +:+       +#+        */
/*                                                +#+#+#+#+#+   +#+           */
/*   Created: 2022/10/25 12:47:30 by nmichael          #+#    #+#             */
/*   Updated: 2022/10/25 13:27:32 by nmichael         ###   ########.fr       */
/*                                                                            */
/* ************************************************************************** */

NO	./images/wall1.xpm
SO	./images/wall2.xpm
WE	./images/wall3.xpm
EA	./images/wall4.xpm

F   220,100,0
C   225,30,0

11111111111111111   11111
10000000000000021   12001
10000000000000001   10001
1000000000000000111110001
1000000000000000000000001
1200000000000000000000001
1000000000000000000000001
1000000000000000000000001
1000000000000000000000001
1000000000000000000000001
1200000000000000000000001
1000000000000000000000001
1000000000000000000000001
1000000000000000000000001
1000000000000000000000001
1000000000000000N00000001
1000000000000000000000001
1200000000000000000000001
1000000000000000000000001
11111000000000000000000011111
    1000000000000000000000021
11111000000000000000000011111
1200000000000000000000001
1200000000000000020000001
1111111111111111111111111




